16 16
################
#              #
# .    $       #
# @             
#              #
#              #
#              #
#              #
#              #
#              #
#              #
#              #
#              #
#              #
#              #
################