   ###
 ###@#
 #   #
## $ #
#.   #
######