####
#. ####
#.$   #
#@ $$ #
###.  #
  #####
