8 8
########
#  #   #
#  $ $$#
#  # #$#
#  # #@#
#  ....#
#  #  ##
########