8 9
#########
#   #   #
#  $$ $ #
#   #@# #
#   #$# #
#   ....#
#   #  ##
#########