###
#.#####
#..   #
# $$$@#
#    ##
######
