6 7
#######
#  ####
# + . #
# $$#@#
##    #
#######