########
#  @ ..#
# $  ###
# $  #
#    #
######