########
#  $ .@#
# $  #.#
#..$ $$#
#..$   #
########