16 16
##############  
#               
# .    $       #
# @   $        # 
#              #
#              #
#              #
#              #
#              #
#              #
#              #
#              #
#              #
#              #
#              #
################