8 8
########
#  #   #
# $$ $ #
#  #@# #
#  #$# #
#  ....#
#  #  ##
########