 ####
 #  #
##  ###
#.  $ #
# +$* #
#     #
#######
