16 16
################$
#              ##
# .    $       #@
# @          s # 
#              #
#              #
#              #
#              #
#              #
#              #
#              #
#              #
#              #
#              #
#              #
################