#########
#   .   #
#   $   #
# .$@$. #
#   $   #
#   .   #
#########