16 16
################$
#              ##
# .    $       #@
# @            # 
#              #
#              #
#              #
#              #
#              #
#              #
#              #
#              #
#              #
#              #
#              #
################