6 7
###
#.#####
# .   #
# $$$@#
#    ##
######
