################$
#              ##
# .    $       #
# @          s # 
#              #
#              #
#              #
#              #
#              #
#              #
#              #
#              #
#              #
#              #
#              #
################