8 8
########
#      #
# .  $ #
# @    #
#      #
#      #
########