16 16
#############.$ 
#               
# .    $       #
# @            # 
#              #
#              #
#              #
#              #
#              #
#              #
#              #
#              #
#              #
#              #
#              #
################